meekd	suppressed
lol	laughing out loud
mk	okay
irl	in real life
ttyl	talk to you later
ty	thank you
sus	suspicious
btw	by the way
thx	thanks
smh	shaking my head
y	why
dm	direct message
bussin	really good
yw	you're welcome
143	i love you
ikr	i know, right?
gf	girlfriend
whoa	expression of surprise
tldr	too long, didn't read
xbf	ex-boyfriend
fml	fuck my life
simp	a person who obsesses over someone
lan	local area network
bsf	best friend
imo	in my opinion
pls	please
ffs	for fuck's sake
nvm	nevermind
hru	how are you
lmfao	laughing my freakin' ass off
ftw	for the win
selfie	a picture a person takes of themself
karen	an entitled woman
tbh	to be honest
tyvm	thank you very much
fr	for real
l8r	later
bbg	baby girl
oic	oh, i see
idek	i don't even know
swag	skills or style
igh	alright
h&k	hugs and kisses
yolo	you only live once
delulu	delusional
14643	i will always love you
feels	feelings
clout chaser	a person who does things just to become popular
gang gang	i'm with you
only in ohio	claiming ohio is strange
skibidi toilet syndrome	adverse effects of watching skibidi toilet
lmirl	let's meet in real life
sux	sucks
hun	honey
noyb	none of your business
bday	birthday
lmao	laughing my ass off
fit	outfit
asl	age, sex, location
lolol	lots of laugh out louds
imu	i miss you
fomo	fear of missing out
lil	little
og	original gangster
mia	missing in action
go brrr	solve a problem
lyl	love you lots
friendversary	friendship anniversary
zaddy	a composed, fashionable, and attractive man
kmab	kiss my ass, bitch
hmu	hit me up
lms	like my status
foh	fuck outta here
bet	you bet
let him cook	don't interfere
cya	see ya
l8	late
imy	i miss you
ngl	not gonna lie
sd	sweet dreams
caught in 4k	caught in the act
s-tier	top rank
cfd	clothing, fashion, design
imho	in my humble opinion
imd	in my dreams
idgaf	i don't give a fuck
tweet	twitter post
wyb	watch your back
mcyt	minecraft youtuber
pm	private message
rly	really
xo	kiss and hug
icymi	in case you missed it
bestie	best friend
mid	mediocre
θδ	therian
aggro	aggressive
ccg	collectible card game
xgf	ex-girlfriend
frfr	for real for real
dunk on	make fun of
ibf	internet best friend
sheesh	expression of disbelief
influencer	a social media user who affects others' behaviors
2h2h	too hot to handle
cmiiw	correct me if i'm wrong
favs	favorites
fetch	cool
and i oop	i'm so embarassed
ymmv	your mileage may vary
lolz	laugh out louds
lk	like
hipster	a person who dislikes mainstream culture
doge	dog
ratioed	receiving many more replies than likes on your tweet
icl	i can't lie
tc	take care
atw	all the way
bw	best wishes
ugh	disappointed
crew	group of friends
obv	obviously
catfish	to assume a false identity
don't @ me	don't mention me in your tweets
mald	mad and bald
tune up	beat up
bffr	be fucking for real
4l	for life
lysm	love you so much
humm	hope you miss me
lpp	likes per post
straight fire	very cool
dm slide	direct message to a crush
bfd	big freakin' deal
trs	that really sucks
tfta	thanks for the add
tcg	trading card game
hifw	how i felt when
thigh gap	space between a person's thighs
clapback	a clever comeback
f4f	follow for follow
comfort idol	a celebrity whose actions soothe you
paper hands	to sell a stock at the first sign of trouble
pog	play of the game
horny on main	acting lustful on your primary social account
based	agree
bion	believe it or not
tay	thinking about you
bffl	best friends for life
wdyt	what do you think
ihy	i hate you
cray	crazy
creeper	a socially invasive person
pmki	pretty much killin' it
vacay	vacation
movember	mustache-growing november
keyboard warrior	a person that posts controversial opinions online
gs	gilvasunner
fyp	for you page
day one	a very close friend
sa	sexual assault
face card	a gorgeous face
jsyk	just so you know
ttys	talk to you soon
wtg	way to go
rt	retweet
hml	hate my life
fav	favorite
adorbs	adorable
hop off	go away
lady boner	female feeling of sexual arousal
secks	sex
pick me	a person desperate for attention and approval
c.ai	character.ai
cyl	catch ya later
wywh	wish you were here
hope	have only positive expectations
tty	talk to you
bling	overly flashy jewelry
handle	twitter username
nae nae	hip-rocking, hand-raising dance move
the struggle is real	having difficulty doing something
chasing clout	doing things just to become popular
simping	obsessing over a person that does not return the same affection
cringe	unpleasant
sigma male	an introverted guy who goes his own way
aslp	age, sex, location, picture
itys	i told you so
mm	music monday
vlog	video blog
potus	president of the united states
poser	a person who pretends to be someone they are not
hny	happy new year
ama	ask me anything
vine	6 second video
tfw	that feeling when
twittersphere	the world of twitter
tbr	to be real
cancel culture	canceling people who do anything controversial
lrt	last retweet
hits different	affects differently
redditor	a reddit user
ot3	one true threesome
blue-checked	verified on twitter
meme stock	a stock hyped on social media
cinnamon roll	a kind, gentle person
sending me	making me laugh
left no crumbs	completely dominated
pro-ship	accepting of any fictional relationship
looksmaxxing	attempting to improve your appearance
ftew	for the epic win
deets	details
larper	live action role-player
chillax	chill and relax
facestalking	looking through someone's pictures on facebook
tbt	throwback thursday
yt	youtube
hmb	hit me back
issa	it's a
sg	silvagunner
big yikes	wow
sip tea	mind your business
alphabet mafia	lgbtqia+ people
doomer	a person who focuses on negative possibilities
lick	theft
rent free in my head	frequently on my mind
sussy baka	suspicious fool
thread	a series of messages
nlt	no later than
weg	wicked evil grin
mishu	miss you
gpoy	gratuitous picture of yourself
hwu	hey, what's up?
delish	delicious
csb	cool story, bro
twinsies	two people who share a common trait
grelfie	group selfie
lurker	a forum user who reads but doesn't post
tl	timeline
fake news	fake news source that pretends to be real
wildin	acting crazy
sock puppet account	a fake online identity
wsg	what's good
algospeak	slang used to bypass content filters
disneybounding	dressing similarly to disney characters
onb	on, bro
alpha male	a dominant male
uttp	utubetrollpolice
2l8	too late
sos	someone special
wbu	what 'bout you
hbd	happy birthday
dah	dumb ass hole
tmg	that's my girl
ptl	praise the lord
tbr	to be read
bbq	barbecue
planking	lying face down and straight like a plank
sbux	starbucks
lebroning	flopping
fire	awesome
facebook friend	a friend on facebook, but most likely not in real life
spill the tea	share the gossip
himbo	a naive, musclebound male
pfp	profile picture
banger	an awesome, energetic piece of media
say less	i understand
date ladder	a person you date to make yourself seem more desirable
passenger princess	a woman whose partner always drives her around
kenergy	conscientious masculinity
op	original poster
ftfy	fixed that for you
d/c	do not care
bnib	brand new in box
slacktivism	lazy activism
demthrones	game of thrones
cbb	can't be bothered
snacc	an attractive person
tiktoker	a tiktok user
gloomer	an apathetic 20-something
e choke	an expression of shock or surprise
unicorn mom	an imperfect, authentic mom who defies mom shaming
sleeper build	when a skinny person is surprisingly buff
edgar	high fade and bowl cut hairstyle
dh	dear husband
iawtc	i agree with the comment
bgf	best guy friend
ifsfy	i feel sorry for you
df	dear fiance
lbvs	laughing but very serious
oomf	one of my followers
tsnf	that's so not fair
derp	expression of stupidity
otp	one true pairing
mcm	man-crush monday
tweetsult	insulting tweet
subtweet	subliminal tweet
aoty	album of the year
fbf	flashback friday
youtuber	a youtube user
put on blast	to call out
whitesplain	to explain something as a white person
slide into your dms	to send a direct message on twitter
quaranteam	a small group that socializes in-person during covid-19
brigading	when one online community harasses another
cottagecore	an aesthetic centered around romanticized rural living
aita	am i the asshole
periodt	an expression of emphasis
moots	people you follow on social media who follow you back
heather	a desirable person
yuck your yum	criticize something you like
boat	best of all time
goated with the sauce	awesome
cgpt	chatgpt
ftr	for the record
lss	long story short
soab	son of a bitch
ihu	i hate you
ome	oh my edward
unfriend	to remove a friend on facebook
wags	wives and girlfriends
tff	twitter follower-friend
poc	proof of concept
ginger	red-head
mistweet	tweet mistake
seltering	sticking out your rear in a fitness pose
dead	hilarious
on fleek	perfect
sfm	so freaking much
crunchy	natural and sustainable lifestyle
poidh	pictures or it didn't happen
celine a scene	to add a celine dion song to a video for maximum emotional impact
fleek	perfect
rip my mentions	i'm going to receive a lot of twitter notifications
tea	truth
clout leech	a person who is friends with someone just to become more popular
cancel	shut down or force out
gobbo	goblin
voteflake	a person who does not accept official election results
outta pocket	disreputable
otl	one true love
gatekeep	to police who has access to an identity or community
momfluencer	a mom who influences other moms on social media
otd	of the day
waifu	a fictional female that a real person has a crush on
ya	young adult
elsagate	inappropriate content targeted at kids on youtube
-core	aesthetic
woke up and chose violence	decided to be hostile
washed	no longer good
beta male	a submissive male
tots and pears	thoughts and prayers
canon event	a pivotal event in a person's life
rizzler	a person with immense charisma
ic	i see
iirc	if i remember correctly
du	don't understand
smf	so much fun
tqvm	thank you very much
bbw	be back whenever
ootd	outfit of the day
gz	congratulations
ahfy	always here for you
gpoyw	gratuitous picture of yourself wednesday
dat	that
sahd	stay-at-home dad
gmafb	give me a friggin' break
tweeps	twitter peeps
dbts	don't believe that stuff
azz	ass
gps	god's positioning system
winternity	eternal winter
live-tweet	to tweet about something currently taking place
instagrammer	an instagram user
snapchatter	snapchat user
bikini bridge	space between a bikini bottom and stomach
covfefe	coverage
clap back	a clever comeback
mood	how i'm feeling
virtue signaling	demonstrating moral superiority
cape	to defend someone's actions, often undeservedly
it me	i identify with that
quaranfifteen	weight gained during covid-19 quarantine
goblincore	an aesthetic centered around overlooked natural things
blursday	literally any day of the week, they're all the same now
bifl	buy it for life
trumper	a donald trump supporter
s	sarcasm
diamond hands	to hold a stock through losses
og	original
nta	not the asshole
mlm	men loving men
wcgw	what could go wrong
parasocial relationship	a one-way relationship between a fan and a creator
who dey breet	who is breathing?
bop	an excellent song or album
afayc	as fast as you can
roaching	secretly dating many romantic partners at the same time
chad	a physically fit, overly confident man
snapback culture	pressure on new moms to snap back to their pre-pregnancy bodies
grwm	get ready with me
the sidewalk rule	your man should walk on the street side of the sidewalk
dyor	do your own research
da	deviantart
nyp	name your price
clapped	beaten
goated	declared the best
boy math	male logic
fcol	for crying out loud
kit	keep in touch
kwim	know what i mean
ltr	long-term relationship
toh	the other half
pc4pc	picture comment for picture comment
omgd	oh my gosh, duh
wadr	with all due respect
fbo	facebook official
f9	fine
u2u	up to you
adm	ay dios mio
gufn	grounded until further notice
ottomh	off the top of my head
ru	are you
fye	for your entertainment
tweetup	twitter meetup
totes	totally
impo	in my personal opinion
hyfr	heck ya, freakin' right
pbuh	peace be upon him
hbbd	happy belated birthday
gif	graphics interchange format
spoopy	spooky and funny
slacktivist	lazy activist
fomof	fear of missing out on football
mfw	my face when
instagram husband	a person who takes pictures of another person for instagram
retweet offender	a person who constantly retweets on twitter
mbfa	make baseball fun again
fb	follow back
twitterstorm	a quick rise of activity about a specific topic on twitter
copypasta	a block of text that is often copied and pasted online
vsco girls	preppy female teen instagrammers
chonk	an overweight animal
slim thick	a female body shape
hnm	happy new month
stimmy	stimulus check
nsfv	not safe for viewing
dadication	fatherly dedication
ysk	you should know
inspo	inspiration
sharent	an oversharing parent on social media
mdl	might delete later
blursed	blessed and cursed
bloomer	a well-adjusted 20-something
bms	broke my scale
crypto mom	sec commissioner hester peirce
tiktok house	a house full of tiktok influencers
yt	whitey
pump your brakes	pause and reflect
silver fox	an attractive older man
bolo	be on the lookout
volcel	voluntary celibate
haunting	following a romantic partner on social media after abruptly leaving them
tw	trigger warning
smol	small and cute
ed	eating disorder
husbando	a fictional man that a real person has a crush on
sub	subreddit
baby trap	when one partner misleads the other to cause a pregnancy
creepypasta	a horror story posted on the internet
go ham	do something intensely
ibr	it's been real
meirl	me in real life
girl dinner	a charcuterie board-esque dinner
jgh	just got home
fanum tax	taking food from a friend
dreamscrolling	scrolling for dream purchases
bd	big deal
iag	it's all good
yvw	you're very welcome
fh	future husband
ygg	you go girl
sat	sorry about that
ia	i agree
yyss	yeah yeah, sure sure
cyf	check your facebook
bffe	best friends forever
ijdgaf	i just don't give a fuck
bcbg	bon chic bon genre
gonna	going to
dur	stupidly obvious
cx	correction
q	coupon
uno	you know
amazeballs	amazing
wcw	woman-crush wednesday
llello	cocaine
shelfie	picture of objects arranged on a shelf
s4s	share for share
faceremorse	remorse after posting on facebook
prt	please retweet
snapstreak	snapchat streak
tbr	to be rude
ghost post	a facebook comment that was removed
ig	instagram
rip to your mentions	you're going to receive a lot of twitter notifications
wig	incredible
rage baking	baking to relieve anger or stress
fitfam	a group of fitness-minded social media users
go off	angrily complain
iykyk	if you know you know
eboy	an extremely online teen boy
headcanon	a fan's unverified beliefs about a story
tifu	today i fucked up
ootl	out of the loop
blackfishing	pretending to be ethnically black
asl	as hell
fax no printer	truth
cmv	change my view
at home	a worse version of something
fogo	fear of going outside
unforced error	an easily-avoidable mistake
crushing it	doing very well
hellmaxxing	committing a series of sinful acts
bing bong	expression of emphasis
seggs	sex
becky	a basic white girl
wbw	wayback wednesday
book hangover	remaining attached to a book you just finished
ate that	dominated
weeb	a non-japanese person obsessed with japanese pop culture
psgwsp	play stupid games, win stupid prizes
squick	a big turn-off
j6	january 6, 2021 u.s. capitol attack
lcs	local comic store
fumble the bag	screw up
academic weapon	a dedicated student
mar10	mario day
vawulence	violence
stacy	an attractive, sexually active woman
ijbol	i just burst out laughing
era	phase
itmt	in the meantime
rtfa	read the flippin' article
tcob	takin' care of business
tic	tongue-in-cheek
twimc	to whom it may concern
pm	postmeridian
mf	mother fucker
loml	love of my life
da	dumb ass
mtf	more to follow
potb	pat on the back
gggb	good girl gone bad
biffles	best friends for life
adpic	always dependably politically incorrect
afaics	as far as i can see
dtrt	do the right thing
mrt	modified retweet
fbf	facebook friend
pous	president of the united states
onco	or nearest cash offer
diaf	die in a fire
tt	trending topic
finna	fixing to
tru	true
viner	vine user
tweeter	a person who tweets
bruh	friend
finstagram	fake instagram account
rinstagram	real instagram account
sotd	shoe of the day
get buckets	to dominate
the gram	instagram
doom-scrolling	scrolling to find bad news
procrastibaking	baking to put off something else
npr	not page related
swipe right	approve
nc	no contact
yta	you're the asshole
tendies	chicken tenders
j-pow	jerome powell
numtots	new urbanist memes for transit-oriented teens
that ain't it	that's no good
wlw	women loving women
nblm	non-binary loving men
hard pants	any non-stretchy pants
perc30	oxycodone, commonly mixed with fentanyl
multistan	an obsessed fan of multiple things
qanutter	a qanon believer
cafo	concentrated animal feeding operation
urbex	urban exploration
wife guy	a social media user who constantly discusses his wife
corn	porn
greenwashing	deceptively claiming to be eco-friendly
ngmi	not gonna make it
oc	original content
comment ghosting	removing a user's comments
insta cop	buy immediately
gtfoh	get the fuck outta here
ooc	out of context
tikbait	shallow tiktok content created to get views
city boy	a man with no regard for women
yahurrd	you heard
galaxy brain	unorthodox thinking
apple sheep	blindly loyal apple fans
edtwt	an eating disorder community on twitter
tradwife	a wife who adheres to traditional values
ftlog	for the love of god
smooth brain	an unintelligent person
sussy	suspicious
wylin	going wild
garbage person	a terrible person
omega male	a self-sufficient, independent male
gamma male	a normal man
npc	a person unable to think for themself
up to eleven	up to an excessive degree
hopium	false hopes
copium	coping via false rationale
aml	anti money laundering
isnotrael	israel is not real
ipad kid	a child who is always on a tablet
blud	bro
boy dinner	a junk food dinner
blackpilled	pessimistic about the future
redpilled	understands an unpleasant truth
whamageddon	the challenge to not hear last christmas
diff	skill difference
witr	why is this relevant
pookie	a loved one
ime	in my experience
ir8	irate
lum	love you, man
nomb	none of my business
sly	still love you
dil	daughter-in-law
imco	in my considered opinion
im	instant messenger
fave	favorite
iluvu	i love you
rgds	regards
dilligaf	do i look like i give a flip?
hk	hugs and kisses
la	laughing a lot
gno	girls' night out
imso	in my sovereign opinion
ftmfw	for the mother fucking win
psp	playstation portable
psog	pure stroke of genius
dyk	did you know
l2m	listening to music
cto	check this out
sinbad	single income no boyfriend absolutely desperate
bbm	brains by mattel
a	hey
jfk	just freakin' kidding
wtfnf	what the fucking fuck
hpdc	happy people don't complain
tmft	too much free time
llpof	liar liar pants on fire
wtv	whatever
sff	so freaking funny
uome	you owe me
obo	or best offer
pl0x	please
gmab	give me a break
ote	over the edge
gby	god bless you
ots	on the scene
wymm	will you marry me?
dweet	drunk tweet
dc	daycare
larp	live action role-playing
larping	live action role-playing
urtb	you are the best
lml	laughing mad loud
idd	indeed
pad	home
srs	serious
rox	rocks
roxorz	rocks
swoll	muscular
opa	greek exclamation
tho	though
lbr	let's be real
tweeple	twitter people
dressgate	controversy about the colors of a dress
b8	bait
pap	post a picture
tsir	the struggle is real
mannequin challenge	challenge that involves one or more people freezing in place
tindering	using tinder
diddy crop	to cut a person out of your life
lb	like back
pto	positive talk only
gram it	post it on instagram
cybermob	a group of online users that harasses other users
wypipo	white people
qotd	question of the day
mbn	must be nice
egirl	an extremely online teen girl
quarantini	a quarantine-times cocktail
acv	after coronavirus
tihi	thanks, i hate it
lpt	life pro tip
quant	quantitative analyst
pharbz	phoebe bridgers fans
nblw	non-binary loving women
qultist	a qanon believer
wokefishing	pretending to have progressive political views
notif	notification
wojak	a microsoft paint-created internet character
pfp	picture for proof
carpe dm	direct message the person now
nocoiner	a person who owns no cryptocurrency
vbo	visible belly outline
baka	fool
chub rub	chafing where your thighs rub together
blow up	to become successful
insta	instagram
lcg	living card game
wtt	watching tiktok
clout demon	a social media user who covets popularity
hot vax summer	summer 2021
1437	i love you forever
hbcu	historically black colleges and universities
pwi	predominantly white institution
cw	content warning
virtual restaurant	delivery-only restaurant
lorge	large
doggo	dog
pupper	puppy
floof	fluff
non-gmo	unvaccinated
astroturfing	faking a grassroots movement
beaning	pouring baked beans on a building's doorstep
otd	on this day
kyle	a basic white boy
arianator	an ariana grande fan
down bad	depressed
iyam	if you ask me
saltine	a white person
s3x	sex
on x games mode	doing something extreme very well
shadowban	to secretly censor a social media user's content
coming for necks	means business
nasl	name, age, sex, location
f2m	female to male
gastrodiplomacy	when a country uses its cuisine to boost its reputation
the streisand effect	when an attempt to hide information draws greater attention
m2f	male to female
marmite character	a person people either hate or love
dldr	don't like, don't read
died	laughed hard
here for it	excited about it
bayc	bored ape yacht club
db8	debate
pull	attract
historybounding	wearing historically-inspired outfits
distwitter	disney twitter
booktwt	book twitter
mtk	mediatek
menty b	mental breakdown
techtoker	a tiktoker who discusses tech
unalive	to kill
goblin mode	behaving badly
ammosexual	a person who loves guns
career cushioning	searching for a new job while employed
womxn	women
quirked up	unusual
unsub	unsubscribe
allat	all that
re	real estate
mascara	boyfriend
sponcon	sponsored content
mc	main character
gagged	rendered speechless
koth	king of the hill
obcd	obesity
afawk	as far as we know
soft life	lifestyle that prioritizes joy and reduces stress
discord kitten	a discord user who acts cute to get gifts
discord daddy	a discord user who gives gifts in exchange for relationships
moneymaxxing	attempting to improve your financial situation
gigachad	an ultra-attractive, confident, and capable man
cheesin	smiling
blue person	a person who changed your life for the better
green person	a close friend you met by chance
killfie	a potentially deadly selfie
gmt	got me tight
oomfie	a twitter follower
croomf	a social media follower crush
do it for the plot	take a chance to make your life more exciting
allg	all good
blue tick	a verified x user
manlet	a short, muscular man
mog	to dominate another man
mogging	dominating another man
bluepilled	unquestioning of conventional beliefs
whammed	hearing the song last christmas
eating good	extremely satisfied
softmaxxing	making minor beauty improvements
aura	coolness
millennial pause	a pause at the start of a video recorded by a millennial
sweater weather	the chilly autumn season
bfcm	black friday cyber monday
fofl	falling on the floor laughing
gdr	grinning, ducking, running
imao	in my arrogant opinion
kir	keepin' it real
lol	lots of love
nombr	none of my business, right
rof	rolling on floor
w2f	way too funny
onyd	oh no you didn't
jmo	just my opinion
ratm	rage against the machine
fw	future wife
goty	game of the year
sahm	stay-at-home mom
wohm	working outside home mom
dkdc	don't know, don't care
mwahugz	kisses and hugs
notd	nail of the day
fotd	face of the day
fttb	for the time being
c4n	ciao for now
dftba	don't forget to be awesome
cpe	coolest person ever
4ward	forward
sbt	sorry 'bout that
bup	backup plan
cyfb	check your facebook
bma	best mates always
bffn	best friend for now
lep	love emo people
iagsmsol	i am getting some money sooner or later
hc	how cool
nb	not bad
ttyootd	talk to you one of these days
afayc	as far as you're concerned
lfw	looking for work
aisi	as i see it
aypi	and your point is?
hhis	hanging head in shame
iyo	in your opinion
tac	that ain't cool
fawc	for anyone who cares
iir	if i remember
iyswim	if you see what i mean
ftfoi	for the fun of it
ditg	down in the gutter
twewbie	twitter newbie
oh	overheard
ht	heard through
nts	note to self
lls	laughing like shit
bfk	big fat kiss
jellz	jealous
ono	or nearest offer
hmp	help me, please
mt	modified tweet
li	linkedin
t4p	thanks for posting
yall	you all
2moz	tomorrow
ermahgerd	oh my gosh
stats	personal profile information
brah	friend
legit	legitimate
spit	to flirt
elo	electric light orchestra
supes	super
cld	could
eavestweeting	eavesdropping on twitter conversations
twaddict	twitter addict
h/t	hat tip
rlrt	real life retweet
dyac	damn you auto correct
kotd	kicks of the day
insta-lurking	looking through a person's instagram pictures
mirl	me in real life
tftf	thanks for the follow
likers get rate	anyone who likes this post will get a rate
finsta	fake instagram account
mention	a reference to a twitter username in a tweet
latergram	a picture posted on instagram later than when it was taken
sksksk	overcome with emotion
ceo of	the best at
bde	big dick energy
went off	angrily complained
zumping	dumping someone over zoom
lal	laugh at life
swipe left	reject
bhm	black history month
idol	a k-pop star
algo	algorithm
accountant	a cover-up occupation
op	outta pocket
mutual	a person you follow on social media who also follows you
bbfbbm	body by fisher, brains by mattel
vpl	visible panty line
fupa	fatty upper pubic area
collab house	a house full of social media influencers
flop era	a period of disappointment
white knighting	saving someone in distress
blep	an animal sticking out part of their tongue
msi	minority-serving institutions
klm	calm
deplatform	to remove a user from a social network or website
digital nomad	a person who performs their job online while traveling
mfeo	made for each other
qrt	quote retweet
trumpster	a donald trump supporter
caucacity	audacity stemming from white privilege
eeyore	a pessimistic person
gdi	god damn it
mukbang	eating show
pick me girl	a female desperate to impress a male
sliving	living your best life
wagmi	we're all gonna make it
dwai	don't worry about it
hcol	high cost of living
ib	inspired by
le dollar bean	lesbian
americancore	a satirical aesthetic centered around american stereotypes
ghost banning	censoring a social media user's posts
woke up and chose chaos	decided to cause trouble
twitter canoe	bloated twitter conversation with 3 or more users
shower thought	an idea that comes to you in the shower
4n6	forensics
aslr	age, sex, location, race
ftm	female to male
sportswashing	using sports to improve a bad reputation
acv	apple cider vinegar
nopoo	no shampoo
cgm	curly girl method
co washing	conditioner-only washing
notp	not one true pairing
sals	ship and let sail
nli	not logged in
w	winning
revenge travel	traveling done to spite covid-19
fanfic	fan fiction
fta	from the article
fanon	unverified story points fans believe are canon
dgmw	don't get me wrong
blag	convince someone to give you something
alr	alright
gray rocking	being dull when interacting with toxic people
regram	to share another instagrammer's post
nunya	none of your
hypebeast	someone who buys into trends
lo	little one
hate sink	a fictional character meant to be hated
costube	costuming youtubers
fomongering	purposefully creating feelings of fomo
hiatus brain	when superfans' minds go wild during a hiatus
pmo	pissed me off
xian	christian
good shout	good idea
red cup day	the day starbucks gives away its new holiday cup
au	alternate universe
buttcoin	a community of cryptocurrency haters
hq	high quality
unsub	unidentified subject
sewerslide	suicide
got that dog in him	driven to succeed
swolemate	a significant other you work out with
frl	for real
boyfriend air	proximity to your boyfriend
flirtationship	when two friends constantly flirt with each other
hg	holy grail
grail	a desirable item
baited	tricked by misleading information
porch pirate	a package thief
wahd	work-at-home dad
dei	diversity, equity, and inclusion
jedi	justice, equity, diversity, and inclusion
mcrmy	my chemical romance fans
noice	very nice
kneecapped	greatly damaged
boyfriend effect	changes experienced since getting a boyfriend
sinkwad	single income, no kids, with a dog
sink	single income, no kids
wybmv	will you be my valentine
deinfluencing	telling social media users what not to do
atbge	awful taste but great execution
prepper	a person who has prepared for catastrophe
psyops	psychological operations
ptso	put that stuff on
wtw	what's the word
sprinkle sprinkle	blessings
tryna	trying to
icydk	in case you didn't know
dtm	doing too much
socialmaxxing	attempting to improve your social skills
own goal	a counterproductive decision
rcta	race change to another
gts	go to sleep
selficide	death caused by taking a selfie
glass child	a child whose sibling requires all their parents' attention
stealth wealth	expensive yet modest items
traumaversary	anniversary of a traumatic event
pmttwamowm	pin me to the wall and make out with me
bachelor's handbag	a takeaway roast chicken
girl math	female financial logic
cbfw	can't be fucked with
solulu	solution
pogging	experiencing surprised excitement
bidness	business
standing on bidness	taking care of business
bf	black friday
cm	cyber monday
it's giving	it's emitting intense feelings
amog	alpha male of group
whitepilled	optimistic about the future
rizzmas carols	slang-filled christmas carol parodies
szn	season
hardmaxxing	making extreme improvements to increase attractiveness
cozy vibes	warm, comfortable, and inviting feelings
flannel mode	embracing all things cozy, rustic, and autumnal
4rl	for real
awol	absent while online
eor	end of rant
g2tu	got to tell you
iso	is seeking other
khyf	know how you feel
lylab	love you like a brother
nw	no way
titf	that is too funny
gr&d	grinning, running, and ducking
dl	doing laundry
am	antemeridian
pmfji	pardon me for jumping in
hom	hit or miss
soh	sense of humor
c&g	chuckle and grin
22	tutu
ilugtd	i love you guys to death
oltl	one life to live
bno	boys' night out
tisnf	that is so not fair
plj	peace, love, joy
sf	science fiction
ilyl	i love you lots
ayc	are you coming?
tmai	tell me about it
lugls	love you girls like sisters
iail	i am in love
laf	laugh
ykhii	you know how it is
du	darn you
wv	with
mysp	myspace
duk	didn't you know?
ltd	lovers 'til death
h8t	hate
alt	a lot
dilligaff	does it look like i give a flying flip?
tpt	trailer park trash
mlia	my life is average
w2g	way to go
anfscd	and now for something completely different
ulkgr8	you look great
q4u	question for you
aysos	are you stupid or something?
bmgwl	busting my gut with laughter
iykwim	if you know what i mean
ddsos	different day, same old stuff
pmji	pardon my jumping in
tttt	these things take time
bits	back in the saddle
dga	digital guardian angel
fos	freedom of speech
gd&rvf	grinning, ducking, and running very fast
hms	hanging myself
fyf	from your friend
kmsl	killing myself laughing
2bz4uqt	too busy for you, cutie
c/s	change subject
wk	week
fbc	facebook chat
bff4l	best friends forever for life
us	ultrasound
lawlz	laugh out loud
asp	after show party
ridic	ridiculous
ht	hat tip
prt	partial retweet
rthx	retweet thanks
tpm	tweets per minute
vlogger	video blogger
asaic	as soon as i can
bootsie	boring person
xtl	cross the line
iccl	i couldn't care less
attwicted	addicted to twitter
tweavesdropping	eavesdropping on twitter
attwaction	attraction to a twitter user
detweet	to delete a tweet
dgyf	dang girl, you're fine
iawtcsm	i agree with this comment so much
ibc	ice bucket challenge
pp	profile picture
lnol	laughing not out loud
felfie	family picture
wealthy selfie	picture of yourself with a large amount of wealth
twitterverse	twitter universe
tylj	thank you lord jesus
snoozle	nap
mrw	my reaction when
icywtbe	in case you went to bed early
twitler	an overbearing twitter user
ribcage bragging	showing off your rib cage
fbriend	a facebook friend
woat	worst of all time
zoom town	a town that many remote workers are moving to
fobo	fear of being on
wuz	what is
bcv	before coronavirus
tek	take
nblnb	non-binary loving non-binary
embiggen	enlarge
fauci ouchie	covid-19 vaccine
lapsonym	a word whose meaning you always forget
valid	excellent
dab hand	an expert
fire thighs	thighs inflamed from chafing
looted	styling
shot girl summer	summer 2021
trans	translation
bts	behind the scenes
tweakin	doing crazy stuff
hwcu	historically white colleges and universities
snapback	the quickness a woman's body snaps back after a pregnancy
take the l	take the loss
comfort character	a fictional character who soothes you
catch these hands	get punched
abow	wow
flurona	having both the flu and covid
twindemic	a dual pandemic
s2g	swear to god
booktok	tiktok users who discuss books
sbf	sam bankman-fried
outwordle	to outsmart a wordle player
amos	add me on snapchat
crop	an edited tiktok video
dni	do not interact
dc	dance credit
leg booty	lgbt
swimmers	vaccinated people
cornucopia	homophobia
sneaky link	secret hook up
queerbaiting	implying but never actualizing a non-hetero relationship
stealth banning	secretly moderating a user's posts
tts	text-to-speech
sub	subscribe
aslnp	age, sex, location, name, picture
aslrp	age, sex, location, race, picture
naslp	name, age, sex, location, picture
gsm	gender and sexuality minority
qpoc	queer people of color
qtpoc	queer and/or trans people of color
anti-ship	against problematic fictional relationships
amaa	ask me almost anything
cakeday	the day a user joins reddit
smo	shout me out
ninjaedit	a quick edit to your post
reddiquette	reddit ettiquette
dtn4l	don't trust no one for life
straight tiktok	mainstream tiktok
alt tiktok	alternative tiktok
wyll	what you look like
chasing the bag	working toward goals
qamaga	an ultra-conservative conspiracy theorist
rashing	insulting
finessing	tricking someone into giving you something
pu	pop up
esb	everybody snap back
su	swipe up
fake body	a video contains revealing clothing
wsp	what's up
goofy ahh	really weird
edtok	an eating disorder community on tiktok
radfem	a radical feminist
yassify	to give a glamorous makeover
yassification	a glamorous makeover
booktube	youtubers who discuss books
dabloons	a fictional tiktok currency
ytber	youtuber
villain mode	not caring about other people's feelings
villain era	putting yourself first
hth	how the heck
dupe	a cheaper stand-in product
smth	something
borg	black out rage gallon
spice	sexual content
bbl	brazilian butt lift
nfs	no funny stuff
petfluencer	a social media user famous for pet content
4d chess	an extremely complex strategy
bpd	borderline personality disorder
cft	combating the financing of terrorism
ghost bike	white roadside memorial bicycle
mfwtk	my friend wants to know
vaguebooking	making deliberately enigmatic social media posts
gendy nooch	gender-neutral
ts and ps	thoughts and prayers
shool	school
ussie	a picture a person takes of themself and someone else
channer	a 4chan user
grief digger	someone who uses a celebrity's death for personal gain
sfv	short-form video
glazing	sucking up to
wtm	what's the move
jit	juvenile in training
2a	second amendment
pink person	the person you love most
reply guy	a man who replies to all of a woman's social media posts
bougie broke	luxurious lifestyle on a budget
bd	baby daddy
lmkwyc	let me know when you can
take him off the grill	shut him down
craptions	bad closed captions
almond mom	a mother who wants her daughter to be skinny
iawtp	i agree with the post
odee	very
balkanization	splintering
splinternet	a splintered internet
vtuber	virtual youtuber
wbk	we been knew
thrift flip	reselling items you bought at a thrift store
gorpcore	an aesthetic centered around outdoor wear
purr	expression of approval
cozzie livs	cost of living
tribe	internet community
pessimize	make worse
tsfw	too stupid for words
po'd	pissed off
snail girl era	taking time to care for yourself
gwenchana	it's alright
ashl	as hell
esh	everyone sucks here
ehs	everyone here sucks
idgas	i don't give a shit
s/o	shout out
ml	my love
dyt	do your thing
smt	something
he's him	he is impressive
dts	death threats
yktv	you know the vibes
acoustic	autistic
silent walking	walking without listening to audio
everything shower	a very involved shower
nothing shower	a rinse-only shower
latte makeup	face makeup that blends warm brown and tan tones
romeo	retired old men eating out
skill issue	you're bad
ctto	credit to the owner
pctto	picture credit to the owner
demure	modest, simple, and mindful
yapping	talking excessively
gen z shake	a shake during a video recorded by a gen zer
dd	dear daughter
dmy	don't mess yourself
ds	dear son
fya	for your amusement
hb	hug back
jtlyk	just to let you know
kysoti	keep your stick on the ice
lylas	love you like a sister
lymi	love you, mean it
moo	my own opinion
vbg	very big grin
m02	my two cents
ilylc	i love you like crazy
juil	just you i love
lig	life is good
cb	chris brown
smdh	shaking my damn head
lolroflmao	laughing out loud, rolling on floor, laughing my ass off
nwo	new world order
bbb	boring beyond belief
4n	foreign
loc	load of crap
lftd	laugh for the day
faf	funny as fuck
crtla	can't remember the three-letter acronym
btwitily	by the way, i think i love you
g9	genius
fusit	fouled up situation
4ever	forever
gic	god's in control
stlsdr	still too long, still didn't read
buf	big, ugly, fat
ifvb	i feel very bad
2moro	tomorrow
tau	thinking about you
sahp	stay-at-home parent
lml	love my life
crn	chuckling right now
owned	dominated
ion	i don't
afda	a few days ago
fri	endless friend
q	question
weathermageddon	very bad weather
bgf	best girl friend
tmb	tweet me back
swm	single white male
instagram prime time	peak hours of instagram activity
rinsta	real instagram account
lewk	look
idw	i don't want
ibfs	internet best friends
cancel club	people that have been shut down or forced out by others
orbiting	following someone on social media without direct interaction
deep like	liking a person's old post on social media
pressed	upset
metoo moment	an experience of sexual abuse or harassment
story time	share more details
gma	give me attention
showmance	a romance between actors starring in the same production
mtf	male to female
hella	very
fobi	fear of being included
panoramic	pandemic
adrod	android
yeen	you ain't even
school air	air that messes with your appearance
trendjacking	hijacking a trend for personal gain
oinkwad	one income, no kids, with a dog
oink	one income, no kids
crine	crying
aomm	always on my mind
bb	bright blessings
gfn	gone for now
irstbo	it really sucks the big one
gbh&k	great big hug and kiss
uw	you're welcome
ysj	you're so jealin'
ttyn	talk to you never
hlbd	happy late birthday
cym	check your myspace
ilmm	i love my man
dyd	don't you dare
pdh	pretty darn hot
nom	no offense meant
mum	mother
chk	check
clk	click
cre8	create
tmw	that moment when
t-giving	thanksgiving
momala	kamala harris
ong	on god
ap	anti-piracy
iktr	i know that's right
s/u	swipe up
bff&e	best friends forever and ever
wdw	walt disney world
2dfm	too dumb for me
jlmk	just let me know
rgd	regard
fomoh	fear of missing out on hockey
ff	follow friday
afdb	a few days back
twollower	twitter follower
bftp	blast from the past
fnb	football and beer
nsfw	not suitable for women
salab	stop acting like a baby
eyc	excited yet calm
swammie	firearm
revine	to repost a vine
pimp	peeing in my pants
cnrhkyitf	chuck norris roundhouse kick you in the face
nsfv	not safe for vegetarians
bbf	body by fisher
yrag	you are a geek
smurf	an alternate account used by a skilled player
gyat	an expression of surprise
gyat	get your act together
aamof	as a matter of fact
twsi	that was so ironic
twti	that was totally ironic
rolmbo	rolling over laughing my butt off
awhfy	are we having fun yet?
duct	did you see that?
dewd	dude
hmp	humph
ceebs	can't be bothered
fho	friends hanging out
gawd	god
fifawwc	fifa women's world cup
dtn	don't trust no one
newsjacking	hijacking a news story to insert your opinion
$	 dollar 
€	 euro 
4ao	for adults only
a.m	before midday
a3	anytime anywhere anyplace
acct	account
adih	another day in hell
afaic	as far as i am concerned
afaict	as far as i can tell
afaik	as far as i know
afair	as far as i remember
afk	away from keyboard
app	application
approx	approximately
apps	applications
asap	as soon as possible
atk	at the keyboard
ave.	avenue
aymm	are you my mother
ayor	at your own risk
b&b	bed and breakfast
b+b	bed and breakfast
b.c	before christ
b2b	business to business
b2c	business to customer
b4	before
b4n	bye for now
b@u	back at you
bae	before anyone else
bak	back at keyboard
bbbg	bye bye be good
bbc	british broadcasting corporation
bbias	be back in a second
bbl	be back later
bbs	be back soon
be4	before
bfn	bye for now
blvd	boulevard
bout	about
brb	be right back
bros	brothers
brt	be right there
bsaaw	big smile and a wink
bwl	bursting with laughter
c/o	care of
cet	central european time
cf	compare
cia	central intelligence agency
csl	can not stop laughing
cu	see you
cul8r	see you later
cv	curriculum vitae
cwot	complete waste of time
cya	see you
cyt	see you tomorrow
dae	does anyone else
dbmib	do not bother me i am busy
diy	do it yourself
dwh	during work hours
e123	easy as one two three
eet	eastern european time
eg	example
embm	early morning business meeting
encl	enclosed
encl.	enclosed
etc	and so on
faq	frequently asked questions
fb	facebook
fc	fingers crossed
fig	figure
fimh	forever in my heart
ft.	feet
ft	featuring
ftl	for the loss
fwiw	for what it is worth
fyi	for your information
gahoy	get a hold of yourself
gal	get a life
gcse	general certificate of secondary education
gg	good game
gl	good luck
glhf	good luck have fun
gmt	greenwich mean time
gmta	great minds think alike
gn	good night
g.o.a.t	greatest of all time
goat	greatest of all time
goi	get over it
gps	global positioning system
gr8	great
gratz	congratulations
gyal	girl
h&c	hot and cold
hp	horsepower
hr	hour
hrh	his royal highness
ht	height
ibrb	i will be right back
icq	i seek you
idc	i do not care
idgadf	i do not give a damn fuck
idgaf	i do not give a fuck
idk	i do not know
ie	that is
i.e	that is
ifyp	i feel your pain
ilu	i love you
ily	i love you
iow	in other words
j4f	just for fun
jic	just in case
jk	just kidding
lb	pound
lbs	pounds
ldr	long distance relationship
lmao	laugh my ass off
lmfao	laugh my fucking ass off
ltd	limited
ltns	long time no see
m8	mate
mf	motherfucker
mfs	motherfuckers
mofo	motherfucker
mph	miles per hour
mr	mister
ms	miss
mte	my thoughts exactly
nagi	not a good idea
nbc	national broadcasting company
nbd	not big deal
nfs	not for sale
ngl	not going to lie
nhs	national health service
nrn	no reply necessary
nsfl	not safe for life
nsfw	not safe for work
nth	nice to have
nvr	never
nyc	new york city
ohp	overhead projector
oic	oh i see
omdb	over my dead body
omg	oh my god
omw	on my way
p.a	per annum
p.m	after midday
pm	prime minister
poc	people of color
pov	point of view
pp	pages
ppl	people
prw	parents are watching
ps	postscript
pt	point
ptb	please text back
pto	please turn over
qpsa	what happens
ratchet	rude
rbtl	read between the lines
rofl	rolling on the floor laughing
roflol	rolling on the floor laughing out loud
rotflmao	rolling on the floor laughing my ass off
ruok	are you ok
sfw	safe for work
sk8	skate
smh	shake my head
sq	square
srsly	seriously
ssdd	same stuff different day
tbs	tablespooful
tbsp	tablespooful
thks	thank you
thx	thank you
tia	thanks in advance
tl;dr	too long i did not read
tldr	too long i did not read
tntl	trying not to laugh
u	you
u2	you too
u4e	yours for ever
utc	coordinated universal time
w/	with
w/o	without
w8	wait
wassup	what is up
wb	welcome back
wtf	what the fuck
wtpa	where the party at
wuf	where are you from
wuzup	what is up
yd	yard
ygtr	you got that right
ynk	you never know
zzz	sleeping bored and tired
